#######################################
# Syntax Coloring Map For PJON
#######################################

# Datatypes (KEYWORD1)

## PJON classes and data types

StrategyLink	KEYWORD1
PJON	KEYWORD1
PJONLocal	KEYWORD1
PJONAny	KEYWORD1
PJONSimpleSwitch	KEYWORD1
PJONSwitch	KEYWORD1
PJONRouter	KEYWORD1
PJONDynamicRouter	KEYWORD1
PJONInteractiveRouter	KEYWORD1
PJONVirtualBusRouter	KEYWORD1
PJONTools	KEYWORD1
PJON_Packet	KEYWORD1
PJON_Endpoint	KEYWORD1
PJON_Packet_Info	KEYWORD1
PJON_Error	KEYWORD1

## Strategies

AnalogSampling	KEYWORD1
Any	KEYWORD1
DualUDP	KEYWORD1
ESPNOW	KEYWORD1
EthernetTCP	KEYWORD1
GlobalUDP	KEYWORD1
LocalFile	KEYWORD1
LocalUDP	KEYWORD1
MQTTTranslate	KEYWORD1
OverSampling	KEYWORD1
SoftwareBitBang	KEYWORD1
ThroughLora	KEYWORD1
ThroughSerial	KEYWORD1

# Methods and Functions (KEYWORD2)

begin	KEYWORD2
can_start	KEYWORD2
device_id	KEYWORD2
get_packets_count	KEYWORD2
include_mac	KEYWORD2
include_port	KEYWORD2
include_sender_info	KEYWORD2
receive	KEYWORD2
remove	KEYWORD2
remove_all_packets	KEYWORD2
ready_to_send	KEYWORD2
reply	KEYWORD2
send	KEYWORD2
send_repeatedly	KEYWORD2
send_packet	KEYWORD2
send_packet_blocking	KEYWORD2
set_acknowledge	KEYWORD2
set_random_seed	KEYWORD2
set_communication_mode	KEYWORD2
set_error	KEYWORD2
set_id	KEYWORD2
set_pin	KEYWORD2
set_pins	KEYWORD2
set_packet_auto_deletion	KEYWORD2
set_receiver	KEYWORD2
set_shared_network	KEYWORD2
set_packet_id	KEYWORD2
strategy	KEYWORD2
update	KEYWORD2

# Instances (KEYWORD2)

PJONAnalogSampling
PJONAny	KEYWORD2
PJONDualUDP	KEYWORD2
PJONESPNOW	KEYWORD2
PJONEthernetTCP	KEYWORD2
PJONGlobalUDP	KEYWORD2
PJONLocalUDP	KEYWORD2
PJONMQTTTranslate	KEYWORD2
PJONOverSampling	KEYWORD2
PJONSoftwareBitBang	KEYWORD2
PJONThroughLora	KEYWORD2
PJONThroughSerial	KEYWORD2

# Constants (LITERAL1)

## PJON basic constants

localhost	LITERAL1
PJON_NOT_ASSIGNED	LITERAL1
PJON_BROADCAST	LITERAL1
PJON_ACK	LITERAL1
PJON_NAK	LITERAL1
PJON_FAIL	LITERAL1
PJON_BUSY	LITERAL1
PJON_SIMPLEX	LITERAL1
PJON_HALF_DUPLEX	LITERAL1
PJON_TO_BE_SENT	LITERAL1

## PJON errors

PJON_PACKETS_BUFFER_FULL	LITERAL1
PJON_CONNECTION_LOST	LITERAL1
PJON_CONTENT_TOO_LONG	LITERAL1

## Constraints

PJON_PACKET_MAX_LENGTH	LITERAL1
PJON_MAX_PACKETS	LITERAL1
PJON_MAX_RECENT_PACKET_IDS	LITERAL1

## Header bits

PJON_MODE_BIT	LITERAL1
PJON_TX_INFO_BIT	LITERAL1
PJON_ACK_REQ_BIT	LITERAL1
PJON_MAC_BIT	LITERAL1
PJON_CRC_BIT	LITERAL1
PJON_EXT_LEN_BIT	LITERAL1
PJON_PORT_BIT	LITERAL1
PJON_PACKET_ID_BIT	LITERAL1

## Conditional feature inclusion

PJON_LOCAL	LITERAL1
PJON_INCLUDE_PACKET_ID	LITERAL1
PJON_INCLUDE_PORT	LITERAL1
PJON_INCLUDE_MAC	LITERAL1

## AnalogSampling

AS_BIT_WIDTH	LITERAL1
AS_BIT_SPACER	LITERAL1
AS_READ_DELAY	LITERAL1
AS_MODE	LITERAL1
AS_TIMEOUT	LITERAL1
AS_RESPONSE_TIMEOUT	LITERAL1
AS_MAX_ATTEMPTS	LITERAL1

## MQTTTranslate

MQTTT_MODE_BUS_RAW	LITERAL1
MQTTT_MODE_BUS_JSON	LITERAL1
MQTTT_MODE_MIRROR_TRANSLATE	LITERAL1
MQTTT_MODE_MIRROR_DIRECT	LITERAL1

## OverSampling

OS_TIMEOUT	LITERAL1
OS_BIT_WIDTH	LITERAL1
OS_BIT_SPACER	LITERAL1
OS_ACCEPTANCE	LITERAL1
OS_MAX_ATTEMPTS	LITERAL1

## SoftwareBitBang
SWBB_BIT_WIDTH	LITERAL1
SWBB_BIT_SPACER	LITERAL1
SWBB_ACCEPTANCE	LITERAL1
SWBB_READ_DELAY	LITERAL1
SWBB_MODE	LITERAL1
SWBB_RESPONSE_TIMEOUT	LITERAL1
SWBB_MAX_ATTEMPTS	LITERAL1
